00 00 00 00 00 00 00 00
00 00 00 00 00 00 00 00
00 00 00 00 00 00 00 00
00 00 00 00 00 00 00 00
00 00 00 00 00 00 00 00 

5f 21 40 00 00 00 00 00
17 21 40 00 00 00 00 00
ef 20 40 00 00 00 00 00
48 00 00 00 00 00 00 00
67 22 40 00 00 00 00 00
be 21 40 00 00 00 00 00
11 22 40 00 00 00 00 00
3b 21 40 00 00 00 00 00
17 21 40 00 00 00 00 00
2e 20 40 00 00 00 00 00
33 31 66 61 37 61 66 34
